,img_1_0,img_1_1,img_1_2,img_2_0,img_2_1,img_2_2,img_2_3,img_2_4,img_2_5,img_3_0,img_4_0,img_5_0,img_6_0,img_6_1,img_6_2,img_6_3,img_7_0,img_10_0,img_10_1,img_10_2,img_14_0,img_14_1,img_14_2
img_1_0,4,0,0,0,0,0,0,0,0,0,0,0,0,0,0,0,0,0,0,0,0,0,0
img_1_1,0,4,0,0,0,0,0,0,0,0,0,0,0,0,0,0,0,0,0,0,0,0,0
img_1_2,0,0,4,0,0,0,0,0,0,0,0,0,0,0,0,0,0,0,0,0,0,0,0
img_2_0,0,0,0,4,0,0,0,0,0,0,0,0,1,1,1,0,0,0,0,0,0,0,0
img_2_1,0,0,0,0,4,0,0,0,0,0,0,0,0,0,0,0,0,0,0,0,0,0,0
img_2_2,0,0,0,0,0,4,0,0,0,0,0,0,0,0,0,0,0,0,0,0,0,0,0
img_2_3,0,0,0,0,0,0,4,0,0,0,0,0,1,2,1,0,0,0,0,0,0,0,0
img_2_4,0,0,0,0,0,0,0,4,0,0,0,0,0,0,0,0,0,0,0,0,0,0,0
img_2_5,0,0,0,0,0,0,0,0,4,0,0,0,0,0,0,0,0,0,0,0,0,0,0
img_3_0,0,0,0,0,0,0,0,0,0,4,0,0,0,0,0,0,0,4,2,4,0,0,0
img_4_0,0,0,0,0,0,0,0,0,0,0,4,0,0,0,0,0,0,0,0,0,0,0,0
img_5_0,0,0,0,0,0,0,0,0,0,0,0,4,1,1,1,1,0,0,1,0,0,0,0
img_6_0,0,0,0,1,0,0,1,0,0,0,0,1,4,0,0,0,0,0,2,0,0,0,0
img_6_1,0,0,0,1,0,0,2,0,0,0,0,1,0,4,0,0,0,0,2,0,0,0,0
img_6_2,0,0,0,1,0,0,1,0,0,0,0,1,0,0,4,0,0,0,1,0,0,0,0
img_6_3,0,0,0,0,0,0,0,0,0,0,0,1,0,0,0,4,0,0,1,0,0,0,0
img_7_0,0,0,0,0,0,0,0,0,0,0,0,0,0,0,0,0,4,0,0,0,0,0,0
img_10_0,0,0,0,0,0,0,0,0,0,4,0,0,0,0,0,0,0,4,0,0,0,0,0
img_10_1,0,0,0,0,0,0,0,0,0,2,0,1,2,2,1,1,0,0,4,0,0,0,0
img_10_2,0,0,0,0,0,0,0,0,0,4,0,0,0,0,0,0,0,0,0,4,0,0,0
img_14_0,0,0,0,0,0,0,0,0,0,0,0,0,0,0,0,0,0,0,0,0,4,0,0
img_14_1,0,0,0,0,0,0,0,0,0,0,0,0,0,0,0,0,0,0,0,0,0,4,0
img_14_2,0,0,0,0,0,0,0,0,0,0,0,0,0,0,0,0,0,0,0,0,0,0,4